NO                            ./Pictures/NO
SO               ./Pictures/SO
WE       ./Pictures/WE
EA            ./Pictures/EA

F 9,255,255
C 4,26,30




        1111111111111111111111111
        1000000000110000000000001
        1011000001110000000000001
        1001000000000000000000001
111111111011000001110000000000001
100000000011000001110111111111111
11110111111111011100000010001
11110111111111011101010010001
11000000110101011100000010001
1000000000000000100000010001
10000000000000001101010010001
1100000111010101110101110N0111
11111111 1111111 101111010001
111    11111 1111111 111111111111